################
#              #
#              #
#              #
#              #
#              #
#              #
#              #
#   p      p   #
################
